11111
100E1
10001
10P01
11011
11011
100E1
10CC1
100C1
11111